0,1,1,1,1,0,0,0,0,0,0,0,0,0,0
1,1,2,2,1,0,1,1,1,1,1,1,1,1,2
1,1,7,1,0,0,1,0,3,0,0,0,0,1,2
1,7,1,1,4,4,4,0,3,0,0,0,0,1,2
0,7,0,1,0,4,0,0,6,0,0,0,0,0,0
0,0,0,1,0,0,0,0,1,0,0,0,0,0,0
0,1,1,1,1,1,1,0,1,0,0,0,0,0,0
0,1,0,5,0,0,0,0,0,0,0,0,0,0,0
0,1,0,5,1,1,1,1,1,0,0,0,0,0,0
1,1,0,5,0,0,0,1,0,0,0,0,0,0,0
0,0,0,1,0,0,0,1,0,0,0,0,0,0,0
0,0,0,1,0,0,0,1,0,0,0,0,0,0,0
0,0,0,1,0,0,0,1,5,0,0,0,0,0,0
0,0,0,1,0,0,0,1,2,0,0,0,0,0,0
2,1,1,1,1,1,1,1,2,0,0,0,0,0,0
