0,0,0,0,0,0,0,0,0,0,0,0,0,0,0
0,1,2,2,2,4,1,1,1,1,1,1,1,1,1
0,1,1,7,2,1,1,1,1,5,0,0,0,0,0
0,2,2,7,1,1,1,1,1,4,0,0,0,0,0
0,0,1,7,1,4,0,1,1,5,0,0,0,0,0
0,0,0,1,5,1,5,5,1,4,3,0,0,0,0
0,1,1,1,5,1,5,5,1,1,0,0,0,0,0
0,5,0,1,5,1,5,5,0,1,0,0,0,0,0
0,1,0,1,1,1,1,1,1,1,0,0,0,0,0
1,1,0,1,0,1,1,1,0,0,0,0,0,0,0
0,0,0,1,0,1,0,1,0,0,0,0,0,0,0
0,0,0,1,0,1,1,1,0,0,0,0,0,0,0
0,0,0,1,0,1,0,1,1,1,0,0,0,0,0
0,0,0,1,0,0,0,1,0,0,0,0,0,0,0
0,0,0,1,0,0,0,1,0,0,0,0,0,0,0